{
    "cols": 8,
    "rows": 8,
    "size": 64,
    "tiles": [
        2, 3, 3, 3, 1, 1, 3, 1,
        1, 1, 1, 1, 1, 1, 1, 1,
        1, 1, 1, 1, 1, 2, 1, 1,
        1, 1, 1, 1, 1, 1, 1, 1,
        1, 1, 1, 2, 1, 1, 1, 1,
        1, 1, 1, 1, 2, 1, 1, 1,
        1, 1, 1, 1, 2, 1, 1, 1,
        1, 1, 1, 1, 2, 1, 1, 1
    ]
}
